NO ./textures/n_tex.xpm
SO ./textures/s_tex.xpm
WE ./textures/w_tex.xpm
EA ./textures/e_tex.xpm

F 200, 100, 100
C 220, 250, 255

11111111111111111111111111111111111111111111111111
10000000010000100001010000000000000010001000001001
10101000100110001100001001011110110000010010101001
10100110101001000000100101000001001000100100100001
10010001001001101111010001000100100001001000111111
11001000010010010000000001010010010010001100000001
10100100101010010010001110010001010010100001000101
10110000000010000100010000001010011010101001101001
10000101011100011000100111110010000100100000010001
10101000100000100001001000001010110010010111010101
10100011001100010010100001000010001010010000100001
10000100010001001010000100110001010001010010001011
10101000101001000010100011000101000100011100001001
10010001000100111100100100010101100010000011000101
11010110001010000010001000101000010010110000011001
10010000110000011010000101000011000100000101000101
10000100000100100001110001010100010010011000100101
10101001110010000100001010001000100011100001000001
10001000001001010001001000010010010100000110010011
10000111100100101010101010100100010101110000100101
10101000010110101010100001001010101000001110000101
10100011010000100000100101010000100001000001110101
10111000001001000011000001000001000000100100000001
10000010010010000100000000010100010010110001001001
10000100010100000100101000100010000100001000100001
10001001000101111010010001001010100100100010100101
10010000111010000001010010001010111000011000010001
10000111000010011000010000010010000011100101001001
10001000011000100100100100001000101000000010001001
10001001000001000100001000110101010111110011010001
10000100100110110101000001000001000000001000100101
11111000010000000100100010010100001000101110000101
10000101011111010010001010100011110111000000000001
10110010000000010011001000101000000000010100111001
10001001111111101000000101000100010010010010000111
11010100000000000111010100010000011001001010110001
10010010010010010000100011001000100010010010000101
10010000010010100100101000100101000100010010001001
10100111000001001001001100101001010001000010000101
10110000100101010100000010100001001000100100010001
10000010001001000011011100111010100110000101001001
10000101110001111000100000000100010001000101010101
10001000001000000010100100000101010100010101010001
11000010101010100100100100111000011010100101011001
10110001001001000100100011000010000000100101000101
10000100001000010100010100111100010000001110100101
1S000100110010100101000100000010101001000100010101
10000100000100101001111001110010101010000101000101
10000100000001000000000010000000100001000001000001
11111111111111111111111111111111111111111111111111
