NO ./textures/n_tex.xpm
SO ./textures/s_tex.xpm
WE ./textures/w_tex.xpm
EA ./textures/e_tex.xpm

F 220, 100, 0       
C 225, 30, 0

 1111 11111111111111111111111111111111111
 1001 10000000000000110000000000000000001
 1111 10110000000001110000000000000000001
      10010000W00000000000000000S00000001
11111110110000000001110000000000000000001
10000000110000000001110000000000000000001
11101111111100000011000000011111111111111
1000000000000000000000000000001
1111111111111111111111111111111
