NO ./textures/n_tex.xpm
SO ./textures/s_tex.xpm
WE ./textures/w_tex.xpm
EA ./textures/e_tex.xpm

F 200, 100, 100
C 220, 250, 255

111111111111111111111111111111111111111111111111111111111111
100000100000100101000000001000000000100000000001000100000011
100110001010010000000001010010011100010011111001010001001001
101000000010010111000010010100100010100000000101010010101N01
101101111001010000100000000101010100100001101001001000000101
100000000100000010010100111001000000100010010001010101010101
100010011000111100011001000101010011001100010101010100000101
101001000010000000000001010101010000010001000101010010101001
100100100100000100000010010001010110010100101010001000000001
110010000000111000111100101000010000010010010000001001011101
101000101101000001000001000100111111001001100110000100000001
101000100000011010011000010101010000100100000001100010001001
100010010011100000100010010001000010000110001010010100010001
100101001000001110000100100000111000011001110010000001010101
101000001110010001000010000010000100100000001100100110010101
101010010001010101100001010011110110100110100001001001100111
101101001001010100011001001000000001001001010000001000010001
100000100101000001000100100100100000010000010010000001001101
110100100001000010010100010000000111100110100011111010100001
101000011000111100100011011110111000010000100000000010000101
100100100100000010001000100001000011000100011111111000011001
100000000011011001000110000101000100100101100000000001000001
101011011000100100100001000100010010101000001001110101110001
110000100010010100101010001001100000100110001110001000001111
100010000100010010101000001010000110010001010000101010010001
101000000100011000100011001000001001100101010011001000010101
100111111011000000010100010100110000001000010100001100011001
101000000000010010000100010001000111000100010111000000000011
101000111110100101011010000001001000110010100000001010011001
100010000000100100100010111010010010000010001111110001100011
100101010011010100001001000010101001000111110000000100010001
100101001100000101010101000100000100001010000111010101001001
100100100000111001010001001010010100110000111000100100101001
110010011001000001011010101000100001000010000110000100101011
100010000110000010000000100100001000100010010001100000101001
101000110000110100100111010001001010100111111100001011001001
100010000001000100010000000110101000100010010001010000010101
100001011000001001011110110000010000100000000101010111100101
100101000101100100000001001001000100101101001110010000001001
100110110010010010110100001010100100010010100100010001000011
101000001010101010001000001010001001000010001001001010111001
100011100010001001101000010010100100100010010010000010000101
100000001000100100001010000100110001000010010000100101010001
100100110010010000100001011001001010001000000110001000011101
101001000010001010001100100100000010000101001001000111000001
100001001100101001010010001111111100010101001010010000101001
110101010001000101010000100100000001001000101001011110110001
100101010001001001001000010000110001010001000101000000000101
100010010010000101001011010010001010000101001000111101011001
101001001100101001001000101101000101100100001001000000100001
101110010000100101101010000000001000010000100000001010010001
100000010111000100001000110011001001011000110110010001010011
100100100000111011110000001000010001000010001001000001001001
101011001110000000000001100100100000100101100100111001100101
101000010000100100010110010101001100100000010010000000010111
101000000010011000001000010100010011001101010011010101010001
101110111001100111100011010110100000100010001000100000100101
100001000110000000010100011001001110110000101110011111001001
100000010000100000000100000000010000000100100000000000000001
111111111111111111111111111111111111111111111111111111111111